SSSSSSSSSSSSSSSSSSSSSSSSS
SV___+____M_M___SS__W_M_S
SSSSSSSSSSSSSS__SS__M___S
_H____SSSSS_H___SS_H____S
BSSSSBSSSH_SSS__SSB___BBS
____M_______M__MSS_MM___S
__SSSSSSMM___M__SS___M__S
____M___M__+__H_SSSH__M_S
SSSSSSSBBSSSSSSSSSS_____S
SSSSSSSBSSSSSSSSS____H__S
>___________M_____M_____S
SSSSSSSSSSSSSSSSSSSSSSSSS