_____H___n__
SSS_S_SSSS__
B___SBS__S__
M___SBS__S__
_B__SSS_KSM_
_________S__
_TBT__M__S__
_TTT__+-_B_M
_________B__
BSSSSBBSSSBM
_V_____M____
___<___>_S__